F 139,108,66
C 255,253,208
NO ./textures/WALLS/NORTH_WALL.xpm
SO ./textures/WALLS/SOUTH_WALL.xpm
WE ./textures/WALLS/WEST_WALL.xpm
EA ./textures/WALLS/EAST_WALL.xpm


111111111111111
    11000000001
 11111000N000011111111111
 110000000000000000001
 111111111000000000011
 1111111111111111000011
               1100011
               1111111