
F 139,108,66
C 255,253,208


NO ./NONE.xpm

SO ./textures/WALLS/SOUTH_WALL.xpm 
WE ./textures/WALLS/WEST_WALL.xpm  
EA ./textures/WALLS/EAST_WALL.xpm  


1111111111111111111111
1000000000100000000001
1000000000000000000001
1000000000000000000001
1100000000000000000001
100000000N000000000001
1100000000000000000001
1000000000000000000001
1000000010101000000001
1111111111111111111111




