F 139,108,66
C 255,253,208


NO ./textures/WALLS/NORTH_WALL.xpm
EA ./textures/WALLS/EAST_WALL.xpm
SO ./textures/WALLS/SOUTH_WALL.xpm 
WE ./textures/WALLS/WEST_WALL.xpm  


11111111111111111111111
10000000000S00000000011111
11111000000000000000000001   1
10000000000000000000011111
1000000000000000000001
1111111100001111111111
1000000000000000000001
1000000000000000000001
1000000000000000000001
1111111111111111111111
